{
    "partitions":
    [
        {
            "x": 0,
            "y": 0,
            "data": [5, 18, 18, 18, 18, 18, 18, 18, 18, 10,
            11, 4, 4, 4, 4, 4, 4, 4, 4, 9,
            11, 4, 4, 4, 4, 4, 4, 4, 4, 9,
            11, 4, 4, 4, 4, 4, 4, 4, 4, 9,
            11, 4, 4, 4, 4, 4, 4, 4, 4, 4,
            11, 4, 4, 4, 4, 4, 4, 4, 4, 9,
            11, 4, 4, 4, 4, 4, 4, 4, 4, 9,
            10, 2, 2, 2, 2, 4, 2, 2, 2, 10]
        },
        {
            "x": 1,
            "y": 0,
            "data":[18, 18, 18, 18, 18, 18, 18, 18, 18, 18,
            18, 4, 5, 5, 5, 4, 4, 4, 4, 18,
            18, 4, 4, 4, 4, 4, 4, 4, 4, 18,
            18, 4, 4, 4, 4, 4, 4, 4, 4, 18,
            4, 4, 4, 4, 4, 4, 4, 4, 4, 18,
            18, 4, 4, 4, 4, 4, 4, 4, 4, 18,
            18, 4, 4, 4, 4, 4, 4, 4, 4, 18,
            18, 18, 18, 18, 18, 18, 18, 18, 18, 18]
        },

        {
            "x": 0,
            "y": 1,
            "data":[18, 18, 18, 18, 18, 4, 18, 18, 18, 18,
            18, 0, 5, 5, 5, 0, 0, 0, 0, 18,
            18, 0, 5, 5, 5, 0, 0, 0, 0, 18,
            18, 0, 5, 5, 5, 0, 0, 0, 0, 18,
            18, 0, 0, 0, 0, 0, 0, 0, 0, 18,
            18, 0, 0, 0, 0, 0, 0, 0, 0, 18,
            18, 0, 0, 0, 0, 0, 0, 0, 0, 18,
            18, 18, 18, 18, 18, 18, 18, 18, 18, 18]
        }
    ] 
}