{
    "partitions":
    [
        {
            "x": 0,
            "y": 0,
            "data": [12, 18, 18, 18, 18, 18, 18, 18, 18, 13,
            11, 4, 4, 4, 4, 4, 4, 4, 4, 9,
            11, 4, 4, 4, 4, 4, 4, 4, 4, 9,
            11, 4, 4, 4, 4, 4, 4, 4, 4, 17,
            11, 4, 4, 4, 4, 4, 4, 4, 4, 4,
            11, 4, 4, 4, 4, 4, 4, 4, 4, 1,
            11, 4, 4, 4, 4, 4, 4, 4, 4, 9,
            20, 3, 4, 1, 3, 4, 1, 2, 2, 21]
        },
        {
            "x": 1,
            "y": 0,
            "data":[12, 18, 18, 18, 18, 18, 18, 18, 18, 13,
            11, 4, 5, 5, 5, 4, 4, 4, 4, 9,
            11, 4, 10, 10, 10, 4, 4, 4, 4, 9,
            19, 4, 10, 10, 10, 4, 4, 4, 4, 9,
            4, 4, 10, 10, 10, 4, 4, 4, 4, 9,
            3, 4, 4, 4, 4, 4, 4, 4, 4, 9,
            11, 4, 4, 4, 4, 4, 4, 4, 4, 9,
            20, 2, 2, 2, 2, 2, 2, 2, 2, 21]
        },

        {
            "x": 0,
            "y": 1,
            "data":[12, 19, 4, 17, 19, 4, 17, 18, 18, 13,
            11, 4, 4, 4, 5, 4, 4, 4, 4, 9,
            11, 4, 5, 4, 5, 4, 4, 4, 4, 9,
            11, 4, 4, 4, 5, 5, 5, 4, 4, 9,
            11, 5, 4, 4, 4, 4, 4, 4, 4, 9,
            11, 4, 4, 4, 5, 5, 5, 4, 4, 9,
            11, 4, 4, 5, 4, 4, 4, 4, 4, 9,
            20, 2, 2, 2, 2, 2, 2, 2, 2, 21]
        }
    ] 
}